1110011111011101111110001000111001110a02022012022222122212020021222022212200112122211220201220102011111110011111101111000111101110011111110111001110110111110111
1000101010101111111010110101001111011a22222202222122222012202020202020001222012022200102222202210111101001010111111101110011110010100100001101110011011111111101
0111111111101111111111111100011111110a10021212122002220222102222012220022221022a22001002110210122101100010111111011011010011000111001111101110110101111111100010
0101011110000100011111101111000100011a20222220222220202222202210222002222022222a12122022012222020111111111101100111001111101011101001110111111101101011110111101
1001111101011011101101111110000010111a12021122202221012222200202222222221202222b02122012220222200101100110110010111111011101100011011010111001100001101011110011
0010011111000110000001111101101110100a21012222102212222200102002021021022121122a22222222020222222111010001001111110111111100111011011111101011110001110111010010
1100101011110110111111110100101110111a20200202000112120200202221022222222022111222221120020120011111111100011011101111000011011010111011110010111111110111111011
0010010111011011110100001111010011001a12012122002211100120220202022221021122122a22000221222122200011111100111111101001101100001110101011010111001111111010001111
1111011011101100110111100111111001111a10222102120122022222001200022022022110022001012200102102022111111111111100101111001011000011101101110110111011111110011100
1001101101111000111011011101111111011a20222102202201210221200111000212122220122210112222122212212010101011100001111111111101001111110101110101111110111101011101
0111011100111111000111111111111111111a22112020222212202222211222021222002201011212021222220212211101011111101101011111000100100110001001010111111111011101110111
0011111010110111111111111101111100110a22222020022222022122021020012220221022102210222221022000202110111110111000110111111110111111101110111101110011011010101111
1111100111101111111111001100110110101a02121110222112222201200222011021110122100021201220220202020011010111110111011001110111101101111010010011110011111000011011
01G1110111111100101011100000011111100a12202222202222010122121220001201222122002020222020220002220111100111111101100111000111010111110000001011111011001101101111
2221202211201022011101011110011111001a02220222002221212202222021120220211201222220222010020220022110010011010101000101001011110001011011110101001011011011101110
0201220222200212001111110111010110111a22212222202212122122220021210212200222222222222121020222222111010100010011100111111111110111001010101101011111110101001100
2222122021021021111110010100100010110a22000220222222012202002220222221022220222a00222202221122200111010001111111110110111100111100011111011111011111101011111101
0221221212220221000101010111110111111a12122222111220201222022220010222220202112b21001221220002022100011110010110011110100110011111111101101100110110111101111111
1212222202220222110111100100101110110a20010210220202212202222201012222222022220222102222221121022001000101000000011111011011101110011101110111111110111111111111
2021122212002201011011101010101101110a20200122202022212221222222210222222022220b00122201102012220110111110111010110101110100101101110101001111111111101100111110
2202110110020222100001110100011001101a22202021222011202200010021002220222011002222220022120022222111001110110111010110000011011000101001101111111000111101101111
0221120221222211101111111011111101000a11201122222200222202102202222212222102222222222222021200212110011010110110110001111111111010111111010000220022122220120022
2002110202122212111010101011111000001a22112210202212021222121221101212022222122aba02a0abb2ba22b20aaaaaaaaaaaaaaaaaaaaaaaaaaaaaaaaaaaaaaaaaaaa2abb2a22a2a22abb2b2
0200022202210202110001111001010111111a22122100120221211212222122222001222202022022020022022202201100111110111011111111011111101111011111110112010102220220201202
0201012202202202111001101011101111111a01101001101111010011010001101022122220020222022222222221210111000011110111011110100111110001110111110100000122122012212212
2020121200000022110110111111010101000a10111111111001111100101000100222221220221222222221222122220111111111111111001111111101111100011111110110102221220122222212
0220222212202002001101111011011010111a10011001000111011111010110001011011011100010101101111001111111100001111101110110111001101110110011011002221201002212122210
2221222122002202100101011111111001101a11110101101111111011011000101111000010011110101110101110111011111110101111011110100100011001101011110102102020201021212222
2022201212122122011010001111110101011a01011101111111111011111011111001111011001110101111111011001100011101111111110011111011111011111010011010222111022202212222
2212022201220222101011111111011110010a01001011101111000111001010101010111100111110101111111101010111110011111011011111101111111001111100111012020022202212222202
0110122021220221011111110101011000111a10001110011110111110101001111111101111010010011101111010001010111100101111101010111000000001010001110112222001222201002002
1221222122220120011111101111101101001a11011110111001111111100111110111101111110111100101011111110101110010110110101011001111101111000010010002212222222022222122
2122212002100122101111110101110111110a11101111110001110110001111011101101111101110111010010111001110111010101011000111111101100101101110111011120210222202212220
0122012020202122111101111100111101111a11111110111101100010011111011010011011011111101110111111100101101010110000111011111101100111111111011111022220222201222012
2010222211220100111111111111101011111a11100111111111100111110111111111111110011aaaaa0aaaaaaaa0a00aaaaaaaaa00aaaaa0aaaaaaaa0aaa0a0a0aa0aaaaaa12202002012211220102
2121222012202020101011111110011111010a01111110111110101101100011111010111101001011111010010010110110001011110101111101110110010011011010111a12011110220222222012
2222222200002202111101100000101011111a01111010011010111101011110011011101100111111011111222112121020000011222121022202111001100101001001000a12220021210222001002
1222222202211222011010111110101100101a11110011111100001111010111001111110110101001101101010010022201022122002200202021111111011101110110011a12022022020021022122
2211022222121222110101101010101100100a01111101101100111110111011110001011001100101111110201221100101022212211221000202101011000001111111111a12222200200002022212
2102010222100220111001110111100101001a00110111110111111111010101101011101100111001001111020202222212012210221120122000110111111110010100011a02022020010010212222
21021212022222221aaaaaaaaaaaaaaaaaaaaa11101101111101111101111011000111000100101101101111202212221000221220020202220200000111011101110100010a10012122122201210220
22222000222220021a1111011001111110011100111111011110101010101110111111011101101110110000202200200221122012222121212212011100011111111001100a01222202121202122222
22022020220200121a1011011111111011110001001001011111111011010110111111001111111100110100212220202202220002201110222212111100101110111111100012122200222020110212
02222012221210201a1011010110111011111011010111111110111010100011011010110100111101111010020222222022222020212000021222111111001010110110011a12122122200212020222
10110011011001001a1011111111101011011110001110111101010011110111101111001111011111011011222222012222222210022221220001111111011011011111001a11200202022102222222
00111110111100111a1111111100000111111101212002000120212020210220222212110111110111101110222020221121020220020122021222111010110110101011110a02100202002212220222
00111111100110100a0110101010110111100101112001220210211022220122202022111110100011100100201222011210111022202010220222001111011111010011111a12222202222222222201
11111111001100010a1011111111111101110010022200220222212102222222212210110010111100111110201202222112122122022000021220011111111110111011101a12022002002222001222
11111011001011111a1111111110111110010011200100222222202221222221221202111101001111111111222222220220222200022021221222111111010111111111100a12010212222212222010
10101110111010010a1110111110100101101011121212102201221120221222012201100010011aaaaaaaaa2b2ba2aabbbb201202222221020122101101011101111101110a12212122220222222202
10100111100110111a0110011101011110100111022222222020222222222120200210011111110101011110022022222222202002221221202101111111011110110111101a02120002220010100222
10111111011111101a0111101111011110100111222102022200222210002122220000101011111001001000122201022112212222202222112211110111011001110111010a11111111110110111010
11001111101010111a1101010111010001100110212220212201202222002012211202110110111001101111220200002002202121200222212002110111001001111110111a01001110011111111110
00101101011111001a111000010100011100100102210221122212000221220222220110110101111001001122022022202b210221222121012222111111001010101111100a01101111110101010100
10110111101101111a111111111011111111000122120222021121211201222201202201110111110101110001222022212a210202022200212112010010001010000101011aaaaaa0a0aa0aaa0aaaaa
00110001000011111a1100111011110111111111222201212121221221220222220200011011000110000110122211122122221000222202222221111001110111111110010010000000101000111101
10101011111111010a0100111110111111101101201112212221220202222102210202110111111011111110102222222222022220022221122201101101110111111100001001111101011111001111
20221222201022011a111111101010011111110101200200120112121220120212212010011101011101101021201020222a210101222222122101100110111101111000110111100111110001101111
20222020022221220a111111110001010111111121020220202220222012212122202210110111101111001002221222212a022020222222200211110100100001001111011011011110101111111101
21220122222021221a0011011001111111111111222202102021202222200221222011101010111111011010112220022122022222202202020022111100110111111101101101110111111011001011
20220220210022220aaaaaaaaaaaaaaaaaaaaa11202211220112002202020220212222110111100111011111200000022222202120222212212122001100111111110001110110101011101011011011
0220200222200200111111111011101111111100122100202221022022122020120021101101011001100100202100221102220222220212222222111111010110100001110111101101010100111011
0121222220202220100101101110111111011111222222220212022121220020010221011111110101111101101022222120000000122211022202111011011111100110111111101000101001101001
2122220222122220001000101111100110110011022220122211022212220222202010000001101011111110222222020212122022222222202221111011111011110111011110111111010111001110
1222212120022122110011111110111011011111222220220212121002012200122011011110011111110011122222222112202200022222200020001110011111111111111111010110100110100111
2222121221122122001011101111100101011100122002211022211202122210100121111011111011101011022202212222022222211222201121011011111010110110110111011111110011011111
021222202202201211111110110010101101100102222022020100202122202212222201011001011110110111110010111a011010111101101011111101001100111111110101111110010101001110
222220212202122011011101001100101110111121220221122210010220222222022210101110110001000010111111111a111111110111111111101011001111110111101111111111011110101101
222221012021012200100011111111110110111020102221212220220011202210020211001111101111110000010111001a101101100111100111001111011111011111111110111111101111111011
210220222012210110110111010011001100111102222220222122120121222020212011011010011110110011110101110aaaaaaaaaaaaaaaaaaaaaaaaaaaaaaaaaaaaaaaaaaaaaaaaaaaaaaaaaaaaa
2022000222021220111010011111111101010111200002202122002221121122022100000010001101110110110011101110100010111011101101101011111011111011001111111111011011011011
0210021200222222100010111111110100101110202100220221200121002022221222110111001111010101111101111100111111111001101110111101100111010000101101111110111110000001
0212022222202222001111111101001111000111220022222220201200222222222202011011010101011111110101110101111111001111110110111111010101111101010011001111101111101110
0222222212221012010101111000100000111101220201222021222222221201002200000111111101111100111000101111111010010111111101110110011110010100001011010110110110100101
0222212012122020111011100111001111011001200020222012012222202222112220111110101110111110011010001011101011111111110011010011100001111101110101101011111101111001
1202221120200220010000000110101000111011010110011111111111001111111011101101011111101011101110111110011111110111111111110111101101011010011111111001001100110011
0202202212222200000111011100111111111111101011011000111111111111100001010111111101101001111110011111011110110111111111110110110111111100111011100111010111101100
1202202202022021110110110110111110111111011010000111011000010011010111011101110111001110111010001111110111010111011111100110011010101111011010111000101101111111
0000021021220200111101100001111111110011110010110111101111100011111111101101111111110111010101011111010011111101111111010111110111111011011110111111100010101010
2201121222022022011111101111011111111010011101111111010111011101110010110111110010111011011110001110000111111110001111111011111011111111110110101001101111111001
2122100222222200111111111111011111011110110111001011011101001011101111101101101100000101110010101110101101000110101110101011100111001100111011110100111011111111
2222202120202122100111101111110001111110111111001010110111011101011110001011111111110111001011010110101101011000001000100101100110110111111010101100110110011111
0220022222120020011111100110101101110000101001111100000111100101111101110011011011101101111101111111110011010110111101000101111101010011011011111100001111111111
2222222220220022111001101000111001000001110001111111001110100111010101100111011100111101111111111110111111111001111111101111110010111100111101011101010100101001
2111022222220220011000100111110111111001101111110010001110111111011110111111100101000001111111111110111111111101011110110110111111111111110001110010111111110111
2211122202122001110010111101001111010111101110111101011011101111111011101101110011110111101101111011111011011110010100101000111011100011111110010101011101010010
1212202002221222110111101111011101111111110000010101010101111001110000001001111111110100101100010101001101101111000100110011011111010001110101110111101111001110
1110111001100011110011110101002001100220202222222211121222100100100000011011110001111111001011111110101001101011010111011100011011111000111110111100100111111100
1001100110111110111111110011022122012120222202202222222122110101011111010101101011011110110011011001111000111111001101111100011110101111001110110010001100101111
1110111111111011101101110001222102022210012221001222022202100111111011111110110001101101111111111100011110011111111111101111011111011011010101101101111011001010
1110011010010011100001111011020111022222220122022001121122101111101100101110000111111111010111100111110101011011100111110101111100011010010011110010000010111111
0111110111110110100101011100202222010221102122002121022121011101010101011111010010110111111011111111110011010111111010011011111111101011111010111111110101110100
1001000111101111111101010111210222120222202022002222122222101110111110111100001110001111111011010111000101101111100100110111001011101101111000110000100111111010
0101111000111111001101001001202122102022221221200210122222111111100000110010101001100111101111101111110001111111111101111101110111111010101001110111111110001011
1010111111001100010111101001022110222202220202222220211122101111011101100000111011011101111011110101010101001100011111111001111111000001111010011010000011111100
0110011100011111111110110111222221212202212020222022022002000111011100111001111111001110110011010110100011110101010101000011100010011111111001010011111110011010
1100110000101101110111011111202012220022220122212012212120010011111000000000111101110011101010111110110111110100011011110100100010111010100011011110011001101100
0011100011010110000001101111010200222220002001222201202022100001111110011100001111101110101011011011011010010101110110110111111011111110101110011011111101010110
0001100011111111111000011111211212202200201101221012020220110111001010110111101110101110100001110111000111111101111011001100011000000111011010011001001111101011
1101001101110111011111110110111222022222221221222202021212010111010101101100111000111110011010100101111000111111110101111111101111011111101111001001110110111101
1111111011101101101111001111121112012120210022222120220222001101010110111101101010100101011111101010011000111111001011111110100100000111101101000101100111100011
1111100100000101010111000101110201122210222022002022022021110111110101111111111100101010001011011101101110110011010111011011110010101010111000011100011001011101
0110111101101101111010011000222221222202222020222221222201100100100111001011101111100111100000111111101001001111011011011111001111011101011110010111101001101000
1110010111100101101001110001212222122012001222222221212220101001001101111011010111111011001011100110111100011111011110101111010110111011111001011111101111111000
0111100110011110011111111101222222212222102202122221220111111111110011110110101110111111111101101110111001100101110001001111011001101111011010111101010110101111
1011011111101110001111111001200200222122212002122210022002011111000011101101100111111100000100011111101111101000111111001101111001110011001101011010101101110111
1011011111101001100001111111112222212201222222102022012222011110111000001010010111010011111111001111111010111011010110111111111101010100111110001011110110010111
1101110010101010110111110111220022222201211200220212221102111101101011111010111110111100101001110000011101111010101111010101101111010111111110011100110111111101
001110111111101110100111011021222110220112222221222222222200110010001100011110111101110010111111110101011111100001101110001100111100011S110011111101101100011111
0011111011101111101011110111202222121202002222221221212210111011011001111111111110111101111111111110101110011101111110111011001111100111000001111001110111100001
1111011111010000101111101000022100002220220212120021222222110110111011110010101011111111100111111100011111111011111100111010111111100111011101111011011111110111
0000010000001111010101110001222221002200222222220122001122111001100111000100111011011110110111010110111111011111000111100110010100011101110100111111100110110111
1111111111111100101110011011222200020200222100201222222102100011110111011110111110010001011101101101100010001111001111111110100110111111111111011101011101110111
1111011111111010011100001111120022220022222222221222220112100101111101110101011011000111110011101111011011011111010101101001101111110011110111100111111111100011
1101100010001110111100110011111221012001120222220220222200010111110111110100011000001111111111100111101010011110000111010101100111110100110111100110000111100011
0111110011111001001110111110020102112001122222211120122220111101111011111111010110111010010111110100111111011000100011100000111101101111110110010110111111011111
1011101001110101101111111011222201221210222110120221021112111101011111110111011100111011011111101101110101011011001000101111010100111100101011110011111111011011
1110100010111100001010011011101101111000000111111111111110111110010001111111000111011111111010111010111001111001011101001101010111110010011110111111011111010010
0101110111110101010101100010111110101111011001100111110100111011111010110001101110011011111100011010011001101100111011110111111001101011111111111101101000001011
0110111111001110111111011111100101011010111110101101111101111010011100101010101110111100111011110100011011111110011111101111101111110011111110101111111101001111
